,id,address,dock_bikes,free_bases,total_bases,latitude,longitude
0,1,Puerta del Sol nº 1,7,11,18,40.4168961,-3.7024255
1,2,Puerta del Sol nº 1,8,10,18,40.4170009,-3.7024207000000002
2,3,Calle Miguel Moya nº 1,7,15,22,40.4205886,-3.7058415
3,4,Plaza del Conde Suchil nº 2-4,11,5,16,40.4302937,-3.7069171
4,5,Calle Manuela Malasaña nº 5,10,12,22,40.4285524,-3.7025875
5,6,Calle Fuencarral nº 108,12,12,24,40.428528,-3.7020599
6,7,Calle Hortaleza nº 63,6,16,22,40.424147999999995,-3.6984470000000003
7,8,Calle Hortaleza nº 75,7,12,19,40.4251906,-3.6977714999999995
8,9,Plaza de Alonso Martínez nº 5,4,18,22,40.427868200000006,-3.6954403
9,10,Plaza de San Miguel nº 9,12,10,22,40.4156057,-3.7095084000000003
10,11,Calle Marqués de la Ensenada nº 16,4,19,23,40.4250863,-3.6918807
11,12,Calle San Andrés nº 18,10,11,21,40.42694829999999,-3.7035918
12,13,Calle San Bernardo nº 85,12,10,22,40.42842460000001,-3.706193100000001
13,14,Calle Conde Duque nº 22,12,11,23,40.4273264,-3.7104417
14,15,Calle Ventura Rodríguez nº 2,9,13,22,40.42609570000001,-3.713479
15,16,Calle San Vicente Ferrer nº 64,8,10,18,40.426164899999996,-3.7073763999999994
16,17,Calle San Bernardo nº 22,7,12,19,40.4230721,-3.7075065
17,18,Plaza de Carlos Cambronero nº 2,11,10,21,40.4232649,-3.7038312000000007
18,19,Plaza de Pedro Zerolo,9,13,22,40.4207773,-3.6996502
19,20,Calle Prim nº 2,4,17,21,40.42186160000001,-3.6954983
20,21,Calle Alcalá nº 49,4,24,28,40.4192342,-3.6954615
21,25,Calle Jacometrezo nº 3,8,13,21,40.4200783,-3.7065376000000003
22,26,Plaza de Santo Domingo nº 1,10,11,21,40.4197429,-3.7080733
23,27,Calle Carlos III nº 1,7,15,22,40.4182146,-3.7103538
24,28,Plaza de Celenque nº 1,5,12,17,40.4173114,-3.7064809000000003
25,29,Plaza de Celenque nº 1,5,12,17,40.417278100000004,-3.7063837
26,30,Plaza de las Salesas 7,5,17,22,40.423854999999996,-3.694475
27,31,Calle Jesús nº 1,8,13,21,40.4132798,-3.6956178
28,32,Calle Alcalá nº 27,3,16,19,40.418166299999996,-3.6992599999999998
29,33,Calle del Marqués de Cubas nº 25,3,18,21,40.4162619,-3.6957355000000014
30,34,Calle Pavía nº 6,8,18,26,40.419209499999994,-3.711504
31,35,Calle Mayor nº 20,10,13,23,40.4163638,-3.7068969
32,36,Plaza de la Provincia nº 1,10,6,16,40.4150099,-3.7061032
33,38,Plaza de Jacinto Benavente,14,7,21,40.4146755,-3.7036824999999998
34,39,Plaza del Cordón nº 1,12,10,22,40.41419310000001,-3.7103285
35,40,Plaza de Ramales nº 1,11,12,23,40.4167281,-3.7124038
36,41,Plaza de San Francisco nº 5,16,6,22,40.41084420000001,-3.7144964
37,42,Carrera de San Francisco nº 1,13,4,17,40.4110406,-3.7120733999999995
38,43,Plaza de la Cebada nº 16 ,17,6,23,40.4112744,-3.7088337
39,44,Plaza del Conde de Romanones nº 9,17,5,22,40.4138846,-3.7049407
40,46,Calle Atocha nº 32,18,3,21,40.41070850000001,-3.6982318
41,47,Calle Lavapiés nº 34-36,17,5,22,40.4101564,-3.7025023999999997
42,48,Calle Mesón de Paredes nº 35,14,4,18,40.409761700000004,-3.7040665999999995
43,49,Glorieta de la Puerta de Toledo nº 1,13,6,19,40.407035799999996,-3.7110513
44,50,Calle Ribera de Curtidores nº 28,15,7,22,40.4053153,-3.7071259
45,51,Glorieta de Embajadores nº 6,12,10,22,40.40478510000001,-3.7028265
46,52,Glorieta de Embajadores nº 2,14,8,22,40.405610700000004,-3.7022591
47,53,Ronda de Atocha nº 34,16,7,23,40.4060941,-3.6992759
48,54,Calle Santa Isabel nº 57,8,12,20,40.4083684,-3.6933462999999995
49,55,Ronda de Atocha nº 2,10,13,23,40.407560600000004,-3.6935205
50,56,Plaza de Santa Ana nº 10,15,5,20,40.4144226,-3.7007163999999997
51,57,Calle Valencia nº 1,16,5,21,40.4089282,-3.7008803
52,58,Calle Barceló nº 7,9,10,19,40.426682799999995,-3.7004230000000002
53,59,Plaza de San Ildefonso nº 3,15,6,21,40.42397570000001,-3.7020842000000003
54,60,Plaza del Carmen nº 1,9,12,21,40.4184192,-3.7032413999999996
55,61,Calle Santa Cruz del Marcenado nº 24,6,16,22,40.4295658,-3.7126299
56,62,Calle Augusto Figueroa nº 33,10,12,22,40.4222862,-3.6978949999999995
57,63,Calle Espíritu Santo nº 30,11,8,19,40.4255495,-3.7043418
58,64,Plaza de la Independencia nº 6,4,18,22,40.419752,-3.6883980000000003
59,65,Calle O'Donnell nº 28,11,12,23,40.42139829999999,-3.6752045
60,66,Calle O'Donnell nº 50,9,13,22,40.4213148,-3.6724968000000002
61,67,Calle Ibiza nº 62,11,11,22,40.4179237,-3.6708959
62,69,Calle Antonio Maura nº 15,6,17,23,40.416560499999996,-3.6904525
63,71,Calle Almadén nº 28,8,14,22,40.4108472,-3.693225
64,72,Calle Espalter nº 1,6,13,19,40.41283720000001,-3.6912023
65,73,Avenida de Alfonso XII nº 54,6,19,25,40.409808,-3.688822
66,74,Avenida de Menéndez Pelayo nº 63,12,10,22,40.41530529999999,-3.6779232000000004
67,75,Calle Doce de Octubre nº 28,15,7,22,40.4159569,-3.6738864999999996
68,76,Calle Doctor Esquerdo nº 99,12,10,22,40.41574129999999,-3.6691837999999994
69,77,Avenida de Nazaret nº 7,15,8,23,40.411447499999994,-3.6689089
70,78,Avenida de Menéndez Pelayo nº 73,13,9,22,40.411762700000004,-3.6766812999999994
71,79,Avenida de Menéndez Pelayo nº 90,15,7,22,40.4082805,-3.6784837999999995
72,80,Avenida del Mediterráneo nº 19,15,7,22,40.40767260000001,-3.6750121
73,81,Plaza del Conde de Casal nº 8,13,7,20,40.40635,-3.6704220000000003
74,82,Calle Cerro de la Plata nº 2,14,8,22,40.400910100000004,-3.6744803999999998
75,83,Avenida de Menéndez Pelayo nº 38,15,8,23,40.4051451,-3.6803873999999994
76,84,Paseo de la Infanta Isabel nº 3,7,15,22,40.4075685,-3.6902255
77,85,Paseo de la Infanta Isabel nº 3,9,16,25,40.4074902,-3.6901233999999996
78,86,Plaza del Emperador Carlos V nº 11,8,14,22,40.409296999999995,-3.691987
79,87,Calle Doctor Esquerdo nº 161,15,8,23,40.4084556,-3.6697526
80,88,Calle Pío Baroja nº 10,10,13,23,40.4130243,-3.6751105
81,89,Calle Doctor Esquerdo nº 191,14,8,22,40.4032501,-3.6726019
82,90,Avenida de Menéndez Pelayo nº 11,11,13,24,40.421501,-3.6800080000000004
83,91,Paseo del Prado nº 1,4,15,19,40.4186148,-3.692621700000001
84,92,Calle Ayala nº 44,5,18,23,40.427735999999996,-3.6832566
85,93,Calle Velázquez nº 75,7,15,22,40.4313576,-3.6838303
86,94,Calle Ayala nº 102,9,13,22,40.427258200000004,-3.6752024
87,95,Calle Goya nº 18,8,21,29,40.4250361,-3.6837876000000014
88,96,Calle Hermosilla nº 70,8,13,21,40.42613400000001,-3.6787441
89,97,Calle Claudio Coello nº 45,5,17,22,40.4262945,-3.6865463
90,98,Calle Goya nº 1,4,18,22,40.4257046,-3.6893697999999997
91,99,Paseo de Recoletos nº 32-34,4,15,19,40.422699,-3.6909648
92,100,Calle Claudio Coello nº 109,4,18,22,40.422658399999996,-3.6870547999999994
93,101,Calle Alcalá nº 111,7,17,24,40.422064,-3.6821792999999996
94,102,Avenida de Menéndez Pelayo nº 3,8,18,26,40.4226906,-3.6801307
95,103,Plaza de Felipe II,8,14,22,40.4242625,-3.675356700000002
96,104,Calle Alcántara nº 2,7,16,23,40.42618510000001,-3.6738714
97,105,Calle Goya nº 99,8,15,23,40.42484570000001,-3.6738635000000004
98,106,Calle Jorge Juan nº 131,15,7,22,40.4231526,-3.6691523
99,107,Calle Alcalá nº 95,5,17,22,40.4211802,-3.6840229
100,108,Calle Ortega y Gasset nº 6,6,16,22,40.43030570000001,-3.6865654
101,109,Paseo de la Castellana nº 4,5,15,20,40.4268331,-3.6895336000000003
102,110,Calle Serrano nº 54,5,17,22,40.4267905,-3.6873921999999997
103,111,Calle Serrano nº 34,6,11,17,40.4251002,-3.6877226999999997
104,112,Calle Serrano nº 34,4,13,17,40.424963,-3.6877449999999996
105,113,Calle Serrano nº 6,4,18,22,40.42152460000001,-3.6884368999999997
106,114,Calle Mártires Concepcionistas nº 2,14,11,25,40.4273005,-3.6706024
107,115,Calle José Ortega y Gasset nº 30,6,17,23,40.4300481,-3.6816402000000004
108,116,Paseo de Moret nº 2,6,16,22,40.4344969,-3.7206892999999996
109,117,Calle Arcipreste de Hita nº 12,9,14,23,40.4337322,-3.7175434999999997
110,118,Calle Arcipreste de Hita nº 12,9,13,22,40.4337036,-3.7175114999999996
111,119,Paseo de Moret nº 11,9,13,22,40.432599100000004,-3.7246532
112,120,Paseo del Pintor Rosales nº 38,8,13,21,40.427657,-3.7205129
113,121,Calle Quintana nº 11-13,10,12,22,40.4277456,-3.7174157999999995
114,122,Calle Evaristo San Miguel nº 2,9,14,23,40.425394399999995,-3.7170447999999996
115,123,Plaza de España,8,14,22,40.42402,-3.7116029999999998
116,124,Plaza de España,7,15,22,40.42412,-3.711703
117,125,Calle Altamirano nº 24,13,9,22,40.4309797,-3.7188898
118,126,Calle Juan Martín el Empecinado nº 14,10,12,22,40.400781,-3.6882406999999997
119,127,Calle Méndez Álvaro nº 11,10,13,23,40.4013216,-3.6863218
120,128,Calle Palos de la Frontera nº 40,15,7,22,40.4032208,-3.6944767999999995
121,129,Paseo de Santa María de la Cabeza nº 58,16,6,22,40.4017926,-3.6987665
122,130,Calle Santa Engracia nº 14,7,16,23,40.4295863,-3.6963983
123,131,Calle Guzmán el Bueno nº 2,11,10,21,40.4306458,-3.7133412000000003
124,169,Calle Manuel Silvela nº 20,14,8,22,40.430952399999995,-3.6993465
125,164,Calle Fernández de la Hoz nº 29,8,14,22,40.435285,-3.6948626000000004
126,163,Calle del General Álvarez de Castro nº 2,16,6,22,40.43447310000001,-3.7015686000000003
127,168,Calle Fernando el Católico nº 19,16,6,22,40.4338516,-3.708439
128,160,Calle Cea Bermúdez nº 59,12,12,24,40.438994,-3.7154328999999997
129,161,Calle José Abascal nº 33,16,6,22,40.4385316,-3.6982209000000004
130,157,Calle Santa Engracia nº 127,13,4,17,40.441386,-3.7016321000000003
131,156,Calle Bravo Murillo nº 44,11,12,23,40.4412115,-3.7039582
132,149,Calle Santa Engracia nº 168,14,8,22,40.4463667,-3.7036675000000003
133,150,Calle Raimundo Fernández Villaverde nº 33-35,10,11,21,40.447125,-3.7001669
134,153,Calle María de Guzmán nº 58,8,15,23,40.4440297,-3.6956047
135,158,Plaza de San Juan de la Cruz nº 11,8,15,23,40.4415974,-3.6927821000000014
136,151,Paseo de la Castellana nº 106,8,14,22,40.4453307,-3.690861
137,152,Plaza de la República Argentina nº 6-7,7,16,23,40.445411,-3.6853312000000007
138,154,Paseo de la Castellana nº 67,4,18,22,40.445741399999996,-3.6917932
139,159,Calle José Gutiérrez Abascal nº 2,7,15,22,40.4396792,-3.6907784
140,162,Calle Velázquez nº 130,7,16,23,40.4379444,-3.682862
141,165,Paseo de la Castellana nº 43,2,9,11,40.4355143,-3.6892367999999993
142,167,Paseo de la Castellana nº 42,6,15,21,40.43340870000001,-3.6879154
143,166,Calle Diego de León nº 52,9,12,21,40.4345973,-3.678492
144,170,Calle Juan Bravo nº 50,9,13,22,40.4323655,-3.6758555
145,171,Calle Ortega y Gasset nº 87,11,11,22,40.429887,-3.6712822999999997
146,155,Calle María Francisca nº 1,9,7,16,40.4442258,-3.6787169
147,148,Avenida del Doctor Arce nº 45,8,14,22,40.4483269,-3.6797296000000004
148,144,Calle Serrano nº 210,8,15,23,40.4510188,-3.6817962
149,146,Paseo de la Habana nº 42,8,14,22,40.449861299999995,-3.6881689
150,147,Paseo de la Castellana nº 124,6,16,22,40.4488924,-3.6905604
151,145,Calle Orense nº 12,5,17,22,40.4480662,-3.695286
152,142,Avenida del General Perón nº 1-4,13,9,22,40.4527164,-3.699007700000001
153,143,Avenida del General Perón nº 36,6,16,22,40.4522938,-3.692651
154,141,Calle Orense nº 36,8,14,22,40.4548456,-3.6946218
155,139,Calle del General Yagüe nº 57,14,8,22,40.4572824,-3.7009675000000004
156,140,Calle Sor Ángela de la Cruz nº 2,7,15,22,40.4592351,-3.691533
157,137,Paseo de la Castellana nº 164,11,11,22,40.4591366,-3.6894150999999997
158,138,Avenida de Alberto Alcocer nº 22,7,15,22,40.458531799999996,-3.684715
159,173,Paseo de la Habana nº 63,11,11,22,40.454385200000004,-3.6835926
160,172,Calle Colombia nº 7,10,12,22,40.45724660000001,-3.6763439
161,132,Paseo de la Florida nº 8,13,11,24,40.4220812,-3.7218482
162,133,Paseo de los Olmos nº 28,15,7,22,40.4034076,-3.7108108
163,134,Paseo de la Esperanza nº 2,13,6,19,40.4035988,-3.7064516000000003
164,136,Paseo de las Delicias nº 92-94,15,7,22,40.39726160000001,-3.6945025
165,135,Paseo de la Chopera nº 14,16,8,24,40.3919385,-3.6971828999999996
166,174,"Calle Segovia, 26",12,10,22,40.4138333,-3.7135833
167,175,Estación nueva 1,6,15,21,40.423966,-3.672684
168,176,Estación nueva 2,8,13,21,40.424521,-3.669691
169,177,Estación nueva 3,7,14,21,40.422969,-3.674262
